7 12 5
############
#S..a...A..#
#..##..$...#
#..T...##..#
#...b..B...#
#.......E..#
############