; ===mapa 2===
7 12 5
############
#S..B...b..#
#..##..A...#
#..$...##..#
#...T..a...#
#.......E..#
############
